0000000000000000000000000000000000000000000000000000000000000000000000000000000000000
2223000000000000000000000000000000000000000000000000000000000000000000000000000004222
1111223000000000000000000000000000000000000000000000000000000000000000000000004221111
1111111000000000000000000000000000000000000000000000000000000000000000000000001111111
1111111000000000000000000000000000000000000000000000000000000000000000000000001111111
1111111222300000000000000000000000000000000000000000000000000000000000000042221111111
1111111111100000000000000000000000000000000000000000000000000000000000000011111111111
1111111111122222222222222220004222222222222222222222222222222222222222222211111111111
1111111111111111111111111110001111111111111111111111111111111111111111111111111111111
111111111111111111111111111LLL1111111111111111111111111111111111111111111111111111111
111111111111111111111111111LLL1111111111111111111111111111111111111111111111111111111
111111111111111111111111111LLL1111111111111111111111111111111111111111111111111111111
111111111111111111111111111LLL1111111111111111111111111111111111111111111111111111111
111111111111111111111111111LLL1111111111111111111111111111111111111111111111111111111
111111111111111111111111111LLL1111111111111111111111111111111111111111111111111111111